#########################################
#               #   #     #   #     #   #
# # ############# # # # ### # # # ### # #
# # #             #   #     #   #     # #
# # # ################# ####### ####### #
#O# #   #       #     # #     #   #   # #
### ### # ### ### ### # # ### ##### # # #
#     # # #   #   # # # # # #   #   #   #
# # ### # # ### ### # ### # ### # ##### #
# # #   # # #   #   #     #   #   #     #
# # # ### ### ### ######### # ##### #####
# # #   #   #   #     #     # #   #     #
# # ### ### ### # ### # ### # ### ##### #
# #   #     # # #   #     # #       #   #
# ######### # # #### #### # ##### ### ###
#         #   #     #   # #     # #   # #
# ##### ## ## ##### # # # ##### ### ### #
#     #   #   #   #   # # #   #     #   #
### ##### # ### # ##### # # # ######### #
#   #     #   # # #  @# #   # #   #   # #
##### ### ### ### # ### ##### # # # # # #
#     # # # #   # #   # #   # # # # #   #
# ##### # # ### # ### # # ### # # # ### #
#     #       # #   # # # #   # # #   # #
# ### ##### ### ### # # # # ### # # # # #
#   #   #   #   #   # # #       # # # # #
### ### # ### ### ### # ######### ### # #
#     # #   # #     # #     # #   #   # #
# ##### # ### ##### # # ### # # ### ### #
# # #   # #   #     # #   # #   #   #   #
# # # ### # ### ### # ### # # ### ### ###
#   #   # # #   #   # #   # #     # # # #
# ##### # # # ##### # ### # ####### # # #
# #     # # #     # #   # # # #       # #
# # # ##### # ### ##### ### # # ####### #
# # # #     # #   #   # #   #   #       #
### ### ##### # ### # # # ##### # ### # #
#   #   #   # # #   #   #     # #   # # #
# ### ### # ### # ########### # ##### # #
#         #     #             #       # #
#########################################
